Abel: The Panther	m
Alfonse: Askran Duo	m
Alfonse: Prince of Askr	m
Alfonse: Spring Prince	m
Alm: Hero of Prophecy	m
Alm: Imperial Ascent	m
Alm: Lovebird Duo	m
Alm: Saint-King	m
Altena: Luminous Rider	f
Altina: Dawn's Trueblade	f
Amelia: Rose of the War	f
Anna: Commander	f
Anna: Wealth-Wisher	f
Annette: Overachiever	f
Arden: Strong and Tough	m
Ares: Black Knight	m
Arthur: Hapless Hero	m
Arvis: Emperor of Flame	m
Astram: Midia's Hero	m
Athena: Borderland Sword	f
Aversa: Dark One	f
Ayra: Astra's Wielder	f
Azama: Carefree Monk	m
Azura: Celebratory Spirit	f
Azura: Lady of Ballads	f
Azura: Lady of the Lake	f
Azura: Vallite Songstress	f
Azura: Young Songstress	f
Bantu: Tiki's Guardian	m
Barst: The Hatchet	m
Bartre: Earsome Warrior	m
Bartre: Fearless Warrior	m
Berkut: Debonair Noble	m
Berkut: Prideful Prince	m
Berkut: Purgatorial Prince	m
Bernadetta: Eternal Loner	f
Beruka: Quiet Assassin	f
Black Knight: Sinister General	m
Boey: Skillful Survivor	m
Brady: Daunting Priest	m
Bramimond: The Enigma	m
Brunnya: Devoted General	f
Bruno: Masked Hare	m
Byleth: Proven Professor	f
Byleth: Tested Professor	m
Caeda: Princess of Talys	f
Caeda: Talys's Bride	f
Caeda: Talys's Heart	f
Cain: The Bull	m
Caineghis: Gallia's Lion King	m
Camilla: Bewitching Beauty	f
Camilla: Flower of Fantasy	f
Camilla: Holiday Traveler	f
Camilla: Light of Nohr	f
Camilla: Spring Princess	f
Camilla: Steamy Secrets	f
Camilla: Tropical Beauty	f
Camus: Sable Knight	m
Canas: Wisdom Seeker	m
Catria: Middle Whitewing	f
Catria: Mild Middle Sister	f
Catria: Spring Whitewing	f
Cecilia: Etrurian General	f
Cecilia: Festive Instructor	f
Ced: Hero on the Wind	m
Celica: Caring Princess	f
Celica: Imprisoned Soul	f
Celica: Queen of Valentia	f
Celica: Warrior Priestess	f
Chad: Lycian Wildcat	m
Charlotte: Money Maiden	f
Cherche: Wyvern Friend	f
Chrom: Crowned Exalt	m
Chrom: Exalted Prince	m
Chrom: Gifted Leader	m
Chrom: Knight Exalt	m
Chrom: Spring Exalt	m
Clair: Highborn Flier	f
Clarine: Refined Noble	f
Clarisse: Sniper in the Dark	f
Claude: The Schemer	m
Clive: Idealistic Knight	m
Conrad: Masked Knight	m
Conrad: Unmasked Knight	m
Cordelia: Knight Paradise	f
Cordelia: Knight Paragon	f
Cordelia: Perfect Bride	f
Cormag: Aloof Lanceman	m
Corrin: Dream Prince	m
Corrin: Dream Princess	f
Corrin: Enjoying Tradition	m
Corrin: Fateful Prince	m
Corrin: Fateful Princess	f
Corrin: Novice Vacationer	f
Corrin: Wailing Soul	f
Cynthia: Hero Chaser	f
Death Knight: The Reaper	m
Deirdre: Lady of the Forest	f
Delthea: Free Spirit	f
Delthea: Tatarrah's Puppet	f
Dimitri: The Protector	m
Donnel: Village Hero	m
Dorcas: Pumpkin Smasher	m
Dorcas: Serene Warrior	m
Dozla: Harvest Attendant	m
Draug: Gentle Giant	m
Duma: God of Strength	m
Echidna: Unyielding Idealist	f
Edelgard: Flame Emperor	f
Edelgard: The Future	f
Effie: Army of One	f
Eir: Merciful Death	f
Eir: Renewed Life	f
Eirika: Anamnesis Lady	f
Eirika: Gentle as Snow	f
Eirika: Graceful Resolve	f
Eirika: Restoration Lady	f
Eldigan: Lionheart	m
Elincia: Estival Princess	f
Elincia: Lost Princess	f
Elise: Bubbling Flower	f
Elise: Budding Flower	f
Elise: Tropical Flower	f
Eliwood: Blazing Knight	m
Eliwood: Devoted Love	m
Eliwood: Knight of Lycia	m
Eliwood: Marquess Pherae	m
Eleonora: Shooting Starlet	f
Ephraim: Dynastic Duo	m
Ephraim: Legendary Lord	m
Ephraim: Restoration Lord	m
Ephraim: Sacred Twin Lord	m
Ephraim: Sparkling Gallantly	m
Est: Junior Whitewing	f
Est: Springtime Flier	f
Ethlyn: Spirited Princess	f
Ewan: Eager Student	m
Eyvel: Mistress of Fiana	f
Fae: Divine Dragon	f
Fae: Holiday Dear	f
Faye: Devoted Heart	f
Faye: Drawn Heartstring	f
Felicia: Maid Mayhem	f
Felicia: Off the Menu	f
Ferdinand: Noblest of Nobles	m
Finn: Lance of Legend	m
Fiora: Airborne Warrior	f
Fiora: Defrosted Illian	f
Fir: Student of Spring	f
Fir: Sword Student	f
Fjorm: Bride of Rime	f
Fjorm: New Traditions	f
Fjorm: Princess of Ice	f
Flame Emperor: Bringer of War	f
Flora: Cold as Ice	f
Flora: Signature Dish	f
Florina: Lovely Flier	f
Forrest: Fashion Forward	m
Forsyth: Loyal Lieutenant	m
Frederick: Horizon Watcher	m
Frederick: Polite Knight	m
Gaius: Candy Stealer	m
Gaius: Thief Exposed	m
Garon: King of Nohr	m
Genny: Dressed with Care	f
Genny: Endearing Ally	f
Gerome: Masked Rider	m
Gerik: Desert Tiger	m
Gharnef: Dark Pontifex	m
Gordin: Altean Archer	m
Gray: Wry Comrade	m
Greil: Heroic Exemplar	m
Gunnthrá: Beaming Smile	f
Gunnthrá: Voice of Dreams	f
Gunnthrá: Year's First Dream	f
Gunter: Inveterate Soldier	m
Gwendolyn: Adorable Knight	f
Haar: Black Tempest	m
Hana: Focused Samurai	f
Hardin: Dark Emperor	m
Hawkeye: Desert Guardian	m
Heath: Wandering Knight	m
Hector: Brave Warrior	m
Hector: Dressed-Up Duo	m
Hector: General of Ostia	m
Hector: Just Here to Fight	m
Hector: Marquess of Ostia	m
Helbindi: Savage Scourge	m
Helbindi: Seaside Scourge	m
Henry: Happy Vampire	m
Henry: Twisted Mind	m
Hilda: Idle Maiden	f
Hinata: Wild Samurai	m
Hinoka: Blue Sky Warrior	f
Hinoka: Relaxed Warrior	f
Hinoka: Warrior Princess	f
Hríd: Icy Blade	m
Hríd: Resolute Prince	m
Hubert: Sinister Servant	m
Iago: Nohr's Tactician	f
Idunn: Dark Priestess	f
Idunn: Dragonkin Duo	f
Igrene: Nabata Protector	f
Ike: Brave Mercenary	m
Ike: Stalwart Heart	m
Ike: Vanguard Legend	m
Ike: Young Mercenary	m
Ilyana: Treat Harvester	f
Inigo: Indigo Dancer	m
Innes: Flawless Form	m
Innes: Regal Strategician	m
Ishtar: Thunder Goddess	f
Ishtar: Thunder's Waltz	f
Itsuki: Finding a Path	m
Jaffar: Angel of Death	m
Jaffar: Angel of Night	m
Jagen: Veteran Knight	m
Jakob: Devoted Monster	m
Jakob: Devoted Servant	m
Jamke: Prince of Verdane	m
Jeorge: Perfect Shot	m
Joshua: Tempest King	m
Julia: Crusader of Light	f
Julia: Naga's Blood	f
Julius: Scion of Darkness	m
Kaden: Kitsune Braggart	m
Kagero: Beverage Ninja	f
Kagero: Honorable Ninja	f
Kagero: Spring Ninja	f
Kana: Dragon Princess	f
Kana: Dragon Spawn	m
Karel: Sword Demon	m
Karla: Sword Vassal	f
Katarina: Wayward One	f
Kaze: Easygoing Ninja	m
Keaton: Lupine Collector	m
Kempf: Conniving General	m
Kiria: Cool Façade	f
Kjelle: Fair Fighter	f
Klein: Silver Nobleman	m
Kliff: Curious Spirit	m
Kronya: Gleaming Blade	f
L'Arachel: Harvest Princess	f
L'Arachel: Princess of Light	f
Lachesis: Lionheart's Sister	f
Laegjarn: Burning Sun	f
Laegjarn: New Experiences	f
Laegjarn: Sheathed Steel	f
Laevatein: Bonfire's Blaze	f
Laevatein: Kumade Warrior	f
Laevatein: Searing Steel	f
Larcei: Keen Kin	f
Larum: Sprightly Dancer	f
Laslow: Dancing Duelist	m
Leanne: Forest's Song	f
Legault: The Hurricane	m
Legion: Masked Maniac	m
Leif: Prince of Leonster	m
Leif: Unifier of Thracia	m
Leila: Rose amid Fangs	f
Lene: Yearning Dancer	f
Leo: Extra Tomatoes	m
Leo: Seashore's Prince	m
Leo: Sorcerous Prince	m
Leon: True of Heart	m
Lethe: Gallia's Valkyrie	f
Lethe: New Year's Claw	f
Lewyn: Guiding Breeze	m
Libra: Fetching Friar	m
Líf: Lethal Swordsman	m
Lilina: Beachside Bloom	f
Lilina: Blush of Youth	f
Lilina: Delightful Noble	f
Lilith: Astral Daughter	f
Linde: Light Mage	f
Linde: Summer Rays	f
Linus: Mad Dog	m
Lissa: Pure Joy	f
Lissa: Sprightly Cleric	f
Lloyd: White Wolf	m
Loki: Spring Trickster	f
Loki: The Trickster	f
Lon'qu: Solitary Blade	m
Louise: Eternal Devotion	f
Lucina: Brave Princess	f
Lucina: Future Witness	f
Lucina: Glorious Archer	f
Lucina: Spring Exalt	f
Lucius: The Light	m
Lugh: Anima Child	m
Lukas: Buffet for One	m
Lukas: Sharp Soldier	m
Luke: Rowdy Squire	m
Lute: Prodigy	f
Lyn: Brave Lady	f
Lyn: Bride of the Plains	f
Lyn: Lady of the Beach	f
Lyn: Lady of the Plains	f
Lyn: Lady of the Wind	f
Lyn: Wind's Embrace	f
Lyon: Shadow Prince	m
Lysithea: Child Prodigy	f
Mae: Bundle of Energy	f
Mamori: Microwavin' Idol	f
Mareeta: Sword of Stars	f
Mareeta: The Blade's Pawn	f
Maria: Minerva's Sister	f
Maribelle: Dire Damsel	f
Marisa: Crimson Flash	f
Marisa: Crimson Rabbit	f
Marth: Altean Groom	m
Marth: Altean Prince	m
Marth: Enigmatic Blade	f
Marth: Hero-King	m
Marth: Legacied Hero	m
Marth: Royal Altean Duo	m
Mathilda: Legendary Knight	f
Matthew: Faithful Spy	m
Mercedes: Kindly Devotee	f
Merric: Changing Winds	m
Merric: Wind Mage	m
Mia: Lady of Blades	f
Mia: Moonlit Witch	f
Micaiah: Priestess of Dawn	f
Micaiah: Queen of Dawn	f
Micaiah: Summer's Dawn	f
Michalis: Ambitious King	m
Midori: Reliable Chemist	f
Mikoto: Caring Mother	f
Minerva: Princess-Knight	f
Minerva: Red Dragoon	f
Mist: Helpful Sister	f
Mist: Purest Spirit	f
Mordecai: Kindhearted Tiger	m
Morgan: Lad from Afar	m
Morgan: Lass from Afar	f
Myrrh: Great Dragon	f
Myrrh: Spooky Monster	f
Naesala: Sky's Shadow	m
Naga: Dragon Divinity	f
Nagi: Dragon Avatar	f
Nah: Little Miss	f
Nailah: Unflinching Eye	f
Nanna: Nordion Princess	f
Narcian: Vernal General	m
Narcian: Wyvern General	m
Navarre: Scarlet Sword	m
Nephenee: Fierce Halberdier	f
Nephenee: Sincere Dancer	f
Niles: Cruel to Be Kind	m
Niles: Forbidden Tease	m
Nils: Bright Bard	m
Nina: Eye Spy	f
Ninian: Bright-Eyed Bride	f
Ninian: Oracle of Destiny	f
Nino: Flower of Frost	f
Nino: Pale Flower	f
Nino: Pious Mage	f
Noire: Shade Seeker	f
Norne: The Volunteer	f
Nowi: Eternal Witch	f
Nowi: Eternal Youth	f
Oboro: Fierce Fighter	f
Odin: Potent Force	m
Ogma: Loyal Blade	m
Oliver: Admirer of Beauty	m
Olivia: Blushing Beauty	f
Olivia: Festival Dancer	f
Olivia: Sky-High Dancer	f
Olwen: Blue Mage Knight	f
Olwen: Righteous Knight	f
Ophelia: Dramatic Heroine	f
Oscar: Agile Horseman	m
Osian: Scolded Soldier	m
Owain: Chosen One	m
Palla: Eldest Bun-Bun	f
Palla: Eldest Whitewing	f
Palla: Sisterly Trio	f
Panne: Proud Taguel	f
Pent: Fancy Fiancé	m
Peony: Sweet Dream	f
Perceval: Knightly Ideal	m
Peri: Playful Slayer	f
Petra: Princess of Brigid	f
Phina: Roving Dancer	f
Priscilla: Delicate Princess	f
Python: Apathetic Archer	m
Quan: Luminous Lancer	m
Raigh: Dark Child	m
Ranulf: Friend of Nations	m
Rath: Wolf of Sacae	m
Raven: Peerless Fighter	m
Rebecca: Wildflower	f
Reinhardt: Lightning's Rondo	m
Reinhardt: Thunder's Fist	m
Reinhardt: Thunder's Sword	m
Reyson: White Prince	m
Rhajat: Black Magician	f
Rinea: Reminiscent Belle	f
Rinkah: Scion of Flame	f
Robin: Fell Reincarnation	m
Robin: Fell Vessel	f
Robin: Festive Tactician	m
Robin: High Deliverer	m
Robin: Mystery Tactician	f
Robin: Seaside Tactician	f
Roderick: Steady Squire	m
Rolf: Tricky Archer	m
Ross: His Father's Son	m
Roy: Blazing Lion	m
Roy: Brave Lion	m
Roy: Young Lion	m
Roy: Youthful Gifts	m
Rutger: Lone Swordsman	m
Rudolf: Emperor of Rigel	m
Ryoma: Dancing Samurai	m
Ryoma: Peerless Samurai	m
Ryoma: Samurai at Ease	m
Ryoma: Supreme Samurai	m
Saber: Driven Mercenary	m
Saias: Bishop of Flame	m
Saizo: Angry Ninja	m
Sakura: Gentle Nekomata	f
Sakura: Hot-Spring Healer	f
Sakura: Loving Priestess	f
Sanaki: Apostle in White	f
Sanaki: Begnion's Apostle	f
Selena: Cutting Wit	f
Seliph: Heir of Light	m
Selkie: Free Spirit	f
Selkie: New Year's Spirit	f
Serra: Outspoken Cleric	f
Seth: Silver Knight	m
Setsuna: Absent Archer	f
Shanna: Sprightly Flier	f
Shannan: Wielder of Astra	f
Sharena: Princess of Askr	f
Sharena: Spring Princess	fSh
Sheena: Princess of Gra	f
Shigure: Dark Sky Singer	m
Shigure: Uplifting Artist	m
Shiro: Raw Talent	m
Siegbert: Future King	m
Sigrun: Loyal Protector	f
Sigrun: Steadfast Bride	f
Sigurd: Holy Knight	m
Silas: Loyal Knight	m
Silque: Adherent of Mila	f
Silque: Selfless Cleric	f
Silvia: Traveling Dancer	f
Sirius: Mysterious Knight	m
Soleil: Adorable Adorer	f
Sonya: Vengeful Mage	f
Sophia: Nabata Prophet	f
Soren: Addled Strategist	m
Soren: Shrewd Strategist	m
Sothe: Zephyr	m
Sothis: Girl on the Throne	f
Sothis: Silver Specter	f
Stahl: Viridian Knight	m
Subaki: Perfect Expert	m
Sue: Doe of the Plains	f
Sully: Crimson Knight	f
Sumia: Maid of Flowers	f
Surtr: Ruler of Flame	m
Tailtiu: Thunder Noble	f
Takumi: Empty Vessel	m
Takumi: Prince at Play	m
Takumi: Prince of Soup	m
Takumi: Wild Card	m
Tana: Noble and Nimble	f
Tana: Winged Princess	f
Tanith: Forthright Heart	f
Tanya: Dagdar's Kid	f
Tethys: Beloved Dancer	f
Tharja: "Normal Girl"	f
Tharja: Dark Shadow	f
Tharja: Obsessive Bride	f
Thea: Stormy Flier	f
Thrasir: Omnicidal Witch	f
Tibarn: Lord of the Air	m
Tiki: Beachside Scion	f
Tiki: Dragon Scion	f
Tiki: Legendary Dragon	f
Tiki: Naga's Voice	f
Tiki: Summering Scion	f
Tiki: Torpid Dragon	f
Titania: Mighty Mercenary	f
Titania: Warm Knight	f
Tobin: The Clueless One	m
Travant: King of Thracia	m
Tsubasa: Madcap Idol	f
Ursula: Blue Crow	f
Ursula: Clear-Blue Crow	f
Valbar: Open and Honest	m
Valter: Dark Moonstone	m
Velouria: Wolf Cub	f
Veronica: Brave Princess	f
Veronica: Spring Princess	f
Virion: Elite Archer	m
Walhart: The Conqueror	m
Wolt: Sunbeam Archer	m
Wrys: Kindly Priest	m
Xander: Dancing Knight	m
Xander: Paragon Knight	m
Xander: Spring Prince	m
Xander: Student Swimmer	m
Yarne: Timid Taguel	m
Ylgr: Breaking the Ice	f
Ylgr: Fresh Snowfall	f
Yune: Chaos Goddess	f
Zelgius: Jet-Black General	m
Zephiel: The Liberator	m
Zephiel: Winter's Crown	m